BBBBBBBBBBBBBBBBBBBBBBBBBBBBBBBBBBBBBBBBBBBBBBBBBBBB
BFFFFFFFFFFFFFFFFFFFFFFFFFFFFFFFFFFFFFFFFFFFFFFFFFFB
BFFFFFFFFFFFFFFFFFFFFFFFFFFFFFFFFFFFFFFFFFFFFFFFFFFB
BFFBBFBBFBBFBBFBBFBBFBBFBBFBBFBBFBBFBBFFFFFFFFFFFFFB
BFFBBFBBFBBFBBFBBFBBFBBFBBFBBFBBFBBFBBFFFFFFFFFFFFFB
BFFBBFBBFBBFBBFBBFBBFBBFBBFBBFBBFBBFBBFFFFFFFFFFFFFB
BFFBBFBBFBBFBBFBBFBBFBBFBBFBBFBBFBBFBBFFFFFFFFFFFBBB
BFFBBFBBFBBFBBFBBFBBFBBFBBFBBFBBFBBFBBFBBFBBFBBFFBBB
BFFBBFBBFBBFBBFBBFBBFBBFBBFBBFBBFBBFBBFBBFBBFBBFFBBB
BFFBBFBBFBBFBBFBBFBBFBBFBBFBBFBBFBBFBBFBBFBBFBBFFBBB
BFFBBFBBFBBFBBFBBFBBFBBFBBFBBFBBFBBFBBFBBFBBFBBFFBBB
BFFFFFFFFFFFFFFFFFFFFFFFFFFFFFFFFFFFFFFFFFFFFFFFFBBB
BFFFFFFFFFFFFFFFFFFFFFFFFFFFFFFFFFFFFFFFFFFFFFFFFBBB
BFFBBFBBFBBFBBFBBFBBFBBFBBFBBFBBFBBFBBFBBFBBFBBFFBBB
BFFBBFBBFBBFBBFBBFBBFBBFBBFBBFBBFBBFBBFBBFBBFBBFFBBB
BFFBBFBBFBBFBBFBBFBBFBBFBBFBBFBBFBBFBBFBBFBBFBBFFBBB
BFFBBFBBFBBFBBFBBFBBFBBFBBFBBFBBFBBFBBFBBFBBFBBFFBBB
BFFBBFBBFBBFBBFBBFBBFBBFBBFBBFBBFBBFBBFBBFBBFBBFFBBB
BFFBBFBBFBBFBBFBBFBBFBBFBBFBBFBBFBBFBBFBBFBBFBBFFBBB
BFFBBFBBFBBFBBFBBFBBFBBFBBFBBFBBFBBFBBFBBFBBFBBFFBBB
BFFBBFBBFBBFBBFBBFBBFBBFBBFBBFBBFBBFBBFBBFBBFBBFFBBB
BFFFFFFFFFFFFFFFFFFFFFFFFFFFFFFFFFFFFFFFFFFFFFFFFBBB
BFFFFFFFFFFFFFFFFFFFFFFFFFFFFFFFFFFFFFFFFFFFFFFFFBBB
BFFFFFFFFFFFBBFBBFBBFBBFBBFBBFBBFBBFBBFBBFBBFBBFFBBB
BFFFFFFFFFFFBBFBBFBBFBBFBBFBBFBBFBBFBBFBBFBBFBBFFBBB
BFFFFFFFFFFFBBFBBFBBFBBFBBFBBFBBFBBFBBFBBFBBFBBFFBBB
BFFFFFFFFFFFBBFBBFBBFBBFBBFBBFBBFBBFBBFBBFBBFBBFFBBB
BFFF1FFFFFFFBBFBBFBBFBBFBBFBBFBBFBBFBBFBBFBBFBBFFBBB
BFFF2FFFFFFFBBFBBFBBFBBFBBFBBFBBFBBFBBFBBFBBFBBFFBBB
BFFF3FFFFFFFBBFBBFBBFBBFBBFBBFBBFBBFBBFBBFBBFBBFFBBB
BFFFFFFFFFFFBBFBBFBBFBBFBBFBBFBBFBBFBBFBBFBBFBBFFBBB
BFFFFFFFFFFFFFFFFFFFFFFFFFFFFFFFFFFFFFFFFFFFFFFFFFFB
BFFFFFFFFFFFFFFFFFFFFFFFFFFFFFFFFFFFFFFFFFFFFFFFFFFB
BBBBBBBBBBBBBBBBBBBBBBBBBBBBBBBBBBBBBBBBBBBBBBBBBBBB
